1111 111
1N01 101
11011101
10000001
11111111