1111 111
1N01 101
11011101111
10000000001
11111111111