1111 111
1N01 101
110111011
100000001
111111111