11111 111
10001 101
1N001 101
110011101111
100000000001
100000000001
111111111111
