1111 111
10N1 101
11011101
10000001
11111111