11111111111
10000S00001
10100000101
10000100001
10100000101
10000100001
11111111111
