1111111
1000001
1000001
10000S1
1111111
NO assets/textures/proto_wall/proto_north.xpm
SO assets/textures/proto_wall/proto_south.xpm
EA assets/textures/proto_wall/proto_east.xpm
WE assets/textures/proto_wall/proto_west.xpm
