1111111111111111
1000000000000001
1000000000000001
10000111111S0001
1000000000000001
1000011111100001
100001    100001
100001    100001
100001    100001
1000011111100001
1000000000000001
1000000000000001
1000011111100001
1000000000000001
1000000000000000
1111111111111111

NO assets/textures/proto_wall/proto_north.xpm
SO assets/textures/proto_wall/proto_south.xpm
EA assets/textures/proto_wall/proto_east.xpm
WE assets/textures/proto_wall/proto_west.xpm

C 0,164,216
F 102,102,102
