1111 111
10N1 101
1001 101
11011101111
10000000001
10000000001
11111111111
