               11111111111111111111
111111         10000000000000000001
100001   11111110111111111111111101
100001   100000001  100000000000101
100001   100000001  100000000000001
100001   100000001  100111111111111
110111111111100111111101111111111111111111111111111
100000111000000000000000000000000000000000000000001
10E000000000000000000000000000000000000000000000001
100000111000000000000000000000000000000000000000001
100000111110111111111111111111111111111111111111111
1110111   101  100001
1000001   101  100001
1000001   10111100001
1000001   10000000001
1111111   11111111111
C 51,51,51
F 51,51,51
NO assets/textures/lab/tile065.xpm
SO assets/textures/lab/tile067.xpm
EA assets/textures/lab/tile068.xpm
WE assets/textures/lab/tile069.xpm
L 94,127,158 66,183,18
L 211,154,0 67,274,18
L 211,0,0 57,82,18
