111111   111111111
100001   100000001
100001   100000001
100001   100000001
100001   100000001
110111111111100111111
100000111000000000001
100000000000000000001
100000111000000000001
100000111110111111111
1110111   101  100001
1000001   101  100001
1000001   10111100001
100N001   10000000001
1111111   11111111111
C 51,51,51
F 51,51,51
NO assets/textures/lab/tile065.xpm
SO assets/textures/lab/tile067.xpm
EA assets/textures/lab/tile068.xpm
WE assets/textures/lab/tile069.xpm
L 255, 150, 70 p 270, 115
L 255, 192, 57 p 270, 25
