  111111111111
  10S000000001
  100000000001
  100000000001
  100000000001
  101010001011
  101010001011
 1100000011011
11101111110001
10000000000001
10000000010001
11111111111111
F  assets/textures/proto_wall/proto_default.xpm
C  assets/textures/proto_wall/proto_default.xpm
NO assets/textures/proto_wall/proto_north.xpm
SO assets/textures/proto_wall/proto_south.xpm
EA assets/textures/proto_wall/proto_east.xpm
WE assets/textures/proto_wall/proto_west.xpm
