  111111111111
  100000000001
  100000000001
  100000000001
  100000000001
  101010001011
  101010001011
 1100000011011
11101111110001
10000000000001
10000000010001
11111111111111
C 0,164,216
F 102,102,102
NO assets/textures/proto_wall/proto_north.xpm
SO assets/textures/proto_wall/proto_south.xpm
EA assets/textures/proto_wall/proto_east.xpm
WE assets/textures/proto_wall/proto_west.xpm
