C 51,51,51
F 51,51,51
NO assets/textures/proto_wall/proto_north.xpm
SO assets/textures/proto_wall/proto_south.xpm
EA assets/textures/proto_wall/proto_east.xpm
WE assets/textures/proto_wall/proto_west.xpm
L 11562,122,37 60,30,10
L 152,122,37 60,30,10
11111111111111
10000000000001
101100S0011001
10110000011001
10000110000001
10110110011001
10110000011001
10000010000001
11111111111111
