11111111111111
100000S0000001
10110000011001
10110000011001
10000110000001
10110110011001
10110000011001
10000010000001
11111111111111
NO assets/textures/proto_wall/proto_north.xpm
SO assets/textures/proto_wall/proto_south.xpm
EA assets/textures/proto_wall/proto_east.xpm
WE assets/textures/proto_wall/proto_west.xpm
