111111
10N001
111001111
100000001
110111101
100001
111111

NO assets/textures/proto_wall/proto_north.xpm
SO assets/textures/proto_wall/proto_south.xpm
EA assets/textures/proto_wall/proto_east.xpm
WE assets/textures/proto_wall/proto_west.xpm

C 0,164,216
F 102,102,102